40 15 150
#####-##################################
#------------O----Y-----------YO--------
#------------OO---------------YOO-------
#------OO-----O---------------YO.-------
#----O--Y--O-----Y------------YO--------
#------x----------O-O-O-------YO--------
#--O-------O--------YY--------YO----Y---
#----Y-------O-------Y--------YO-------O
----------YO------------------YO--------
#---.------O--Y----#----------YO--------
#-.---.----------------O------YO--------
#--O.------O-------O-----?----YO--------
#--.-Y-------O----------------YO--------
----------YO-----O------------YO-------O
#----------O--Y----#----------YO--------
