12 7 23
############
#xO######O?#
#Y-O####O-Y#
##Y-O##O-Y##
###Y-OO-Y###
####YYYY####
------------
