21 10 100
#####-###############
#..-.....----O----Y-#
#--x---------OO-----#
#------OO-----O-----#
#----O--Y--O-----Y--#
#-------------------#
#--O-------OY-------#
#----Y-------O###---#
----------YO----#----
#----------O--?-#--##
