14 8 25
##############
#---#---------
#--x#---------
#---#OOOOY----
#----YYYYYO---
#----OOOO-----
#-------------
#-----------?
