20 10 100
#####-##############
#..-.....----O----Y-
#--x---------OO-----
#------OO-----O-----
#----O--Y--O-----Y--
#-------------------
#--O-------O--------
#----Y-------O------
----------YO--------
#----------O--?----#
